NO ../textures/tiles/brick.xpm
SO ../textures/tiles/pink_plank.xpm
WE ../textures/tiles/sand.xpm
EA ../textures/tiles/white_plank.xpm
C 164,211,k
F 61,65,75


 111111
 100101
 101001
 1100N1
 111111
