NO ../textures/tiles/brick.xpm
SO ../textures/tiles/pink_plank.xpm
WE ../textures/tiles/sand.xpm
EA ../textures/tiles/white_plank.xpm
F 61,65,75
C 122,133,143

1111111111
1000000001
1011111101
101    101
101    101
101    001
101    101
1011111101
1N00000001
1111111111
